R 80 80 

NO 4829
SO pics/bluestone.xpm
WE pics/mossy.xpm
EA pics/redbrick.xpm
S pics/pillar.xpm 

C 255, 9 ,9 
F 1 , 2, 255

111111111    
100000001   
102020201  
100000001     1
102020201    101
100001111111111
10000000S00001111
11111111111111111111
 
1111
