R 800 600
NO pics/greystone.xpm
SO pics/bluestone.xpm
WE pics/mossy.xpm
EA pics/redbrick.xpm
S pics/pillar.xpm

C 225,30,30
F 25,30,30

111111111    1111111
100500001    1004001
102020201    1001001
100000001    1001001
102020201    1001001
10000000011111001001
100000000000000010N1
11111111111111111111
